border_size=1
usage=map

Gs          , Gs          , Mm          , Gs          , Aa^Fpa      , Gs          , Gs^Fp       , Gs^Fp       , Gs^Fp       , Gs^Fp       , Gs^Fp       , Gs          , Gs          , Gs          , Gs          , Gs          , Gs          , Gs          , Gs          , Gs          , Gs          , Gs          , Gs          , Gs          , Gs          , Gs          
Gs          , Mm          , Mm          , Aa^Fpa      , Mm          , Aa^Fpa      , Aa^Fpa      , Gs^Fp       , Aa^Fpa      , Gs^Fp       , Gs^Fp       , Gs          , Gs          , Gs          , Gs          , Gs          , Gs          , Gs          , Gs^Vht      , Gs          , Gs          , Gs          , Gs          , Gs          , Gs          , Gs          
Gs          , Gs^Fp       , Gs^Fp       , Mm          , Mm          , Mm          , Mm          , Aa^Fpa      , Gs^Fp       , Gs^Fp       , Gs^Fp       , Gs^Fp       , Gs          , Gs          , Gs          , Gs          , Gs          , Gs          , Gs          , Gs          , Chr         , Chr         , Chr         , Gs          , Gs          , Gs          
Gs          , Ha          , Gs^Fp       , Ww          , Ww          , Gs          , Gs          , Mm          , Gs          , Gs^Fp       , Gs          , Gs          , Gs          , Gs          , Gs^Fp       , Gs          , Gs          , Gs          , Gs          , Gs          , Chr         , 3 Khr       , Chr         , Gs          , Gs          , Gs          
Gs          , Ha          , Ha          , Gs^Fp       , Ww          , Gs          , Gs          , Mm          , Gs          , Gs          , Gs          , Gs          , Gs^Fp       , Gs^Fp       , Gs          , Gs          , Gs^Vht      , Gs          , Gs          , Gs          , Gs          , Chr         , Gs          , Gs          , Gs          , Gs          
Gs          , Ha          , Gs^Fp       , Gs^Fp       , Ww          , Gs          , Gs          , Mm          , Gs          , Gs          , Gs          , Gs^Fp       , Gs          , Gs          , Gs          , Gs          , Gs          , Gs          , Gs          , Gs          , Gs          , Gs          , Gs          , Gs          , Gs          , Gs          
Gs          , Gs^Fp       , Gs          , Gs          , Ww          , Gs          , Gs          , Hh^Fdf      , Hh^Vhh      , Gs          , Gs^Fp       , Gs^Fp       , Gs          , Gs          , Re          , Re          , Gs          , Gs          , Gs          , Gs          , Gs          , Gs          , Gs          , Gs^Vht      , Gs          , Gs          
Gs          , Gs          , Gs          , Gs          , Gs          , Ww          , Gs          , Hh^Fdf      , Gs          , Gs          , Gs          , Gs          , Gs          , Re          , Gs          , Gs          , Gs          , Gs          , Gs^Fp       , Gs^Fp       , Gs^Fp       , Gs          , Gs^Fp       , Gs          , Gs          , Gs          
Gs          , Gs          , Gs          , Gs          , Gs          , Ww          , Gs          , Gs          , Gs          , Gs          , Re          , Gs          , Gs          , Gs          , Gs          , Gs          , Gs^Fp       , Gs^Fp       , Gs          , Gs          , Gs          , Gs^Fp       , Gs          , Gs          , Ss          , Gs          
Gs          , Gs          , Gs          , Gs          , Gs          , Ww          , Gg^Vc       , Gs          , Re          , Re          , Gs          , Gs          , Gs          , Gs          , Gs          , Gs          , Gs          , Gs          , Gs^Fdf      , Gs          , Gs^Fp       , Gs^Fp       , Ss          , Gs          , Gs          , Gs          
Gs          , Gs          , Gs          , Gs          , Gg^Vc       , Wwf         , Re          , Re          , Gs          , Gs          , Gs          , Gs          , Gs          , Gs          , Gs          , Gs          , Gs          , Gs^Fp       , Gs          , Gs^Fdf      , Gs          , Ss          , Ss          , Ss^Vm       , Gs          , Gs          
Gs          , Gs          , Gs^Fp       , Gs^Fp       , Re          , Wwf         , Gs^Fp       , Ce          , Gs^Fdf      , Gs          , Gs          , Gs          , Gs          , Gs          , Gs          , Gs          , Gs          , Gs          , Gs          , Gs          , Gs          , Ss          , Ss          , Gs          , Ss          , Gs          
Gs          , Gs^Fp       , Gs^Fp       , Gs^Fp       , Re          , Ww          , Ke          , Ce          , Gs^Fp       , Gs^Fp       , Ss          , Gs          , Gs          , Gs          , Ss          , Gs          , Gs          , Gs          , Ss          , Gs          , Gs          , Ss          , Ss          , Ss          , Ss          , Gs          
Gs          , Gs^Fp       , Gs          , Ce          , Ww^Bw|      , Ww          , Ww          , Ds          , Ds          , Ss          , Ww          , Ss          , Ds          , Ds          , Ww          , Ss          , Ds          , Ds          , Ww          , Ds          , Ds          , Ss          , Ww          , Ss          , Ww          , Gs          
Wo          , Ds          , Ds          , Ds          , Ww^Bw|      , Ww          , Chw         , Ww          , Ww          , Ww          , Ww          , Ww          , Ww          , Ww          , Ww          , Ww          , Ww          , Ww          , Ww          , Ww          , Ww          , Hh          , Wo          , Ww          , Ww          , Gs          
Wo          , Wo          , Wo          , Ww          , Chw         , Ww^Bw\      , Ww          , Ww          , Wo          , Ww          , Wo          , Wo          , Wo          , Wo          , Wo          , Wo          , Wo          , Wo          , Wo          , Wo          , Wo          , Wo          , Hh          , Wo          , Wo          , Ww          
Wo          , Wo          , Wo          , Ww          , Ww          , Ww^Bw|      , Ww          , Ww          , Ww          , Wo          , Ww          , Ww          , Ww          , Ww          , Ww          , Ww          , Ww          , Ww          , Ww          , Ww          , Ww          , Ww          , Hh          , Ww          , Ww          , Wo          
Wo          , Wo          , Gs          , Ww          , Ww          , Ww^Bw|      , Ce          , Ww          , Ww          , Ww          , Gs^Fdf      , Ww          , Ww          , Ww          , Ww          , Ww          , Gs^Fp       , Ww          , Gs^Fp       , Ww          , Hh          , Hh          , Hh          , Ss          , Ss          , Ss          
Gs          , Gs          , Gs          , Ce          , Gs          , Rr          , Ce          , Gs          , Gs^Fdf      , Gs          , Gs          , Gs          , Gs          , Gs^Fdf      , Gs          , Gs          , Gs          , Gs          , Gs          , Hh          , Hh          , Hh          , Hh          , Gs          , Gs          , Gs          
Gs          , Gs          , Gs          , Ce          , Ce          , Rr          , Ce          , Gs          , Gs          , Gs          , Gs          , Gs          , Gs          , Gs          , Gs          , Gs          , Gs          , Gs          , Gs          , Hh          , Mm          , Mm          , Hh          , Gs          , Gs          , Gs          
Gs          , Gs          , Gs          , Gs          , Gs          , Ke          , Gs          , Gs          , Gs          , Gs          , Gs          , Gs          , Gs          , Gs          , Gs          , Gs          , Gs          , Gs          , Gs          , Hh          , Hh          , Mm          , Hh          , Gs          , Gs          , Gs          
Gs          , Gs          , Gs          , Gs          , Gs          , Rr          , Gs          , Gs          , Gs          , Gs          , Gs          , Gs          , Gs          , Gs          , Gs          , Gs          , Gs          , Gs          , Gs          , Gs          , Gs          , Hh          , Gs          , Gs          , Gs          , Gs          
Gs          , Gs          , Gs          , Gs          , Gs          , Rr          , Gs          , Gs          , Gs          , Gs          , Gs^Fdf      , Gs^Fp       , Gs          , Gs          , Gg^Ve       , Gs          , Gs          , Gs          , Gs          , Gs          , Gs          , Gs          , Gs          , Gs          , Gs          , Gs          
Gs          , Gs          , Gs          , Gs          , Gs          , Rr          , Rr          , Gs          , Gs^Fdf      , Gs^Fdf      , Gs          , Gs^Fp       , Gs          , Gs          , Re^Gvs      , Gs          , Gg^Ve       , Gs          , Gs          , Gs          , Gg^Fet      , Gs          , Gs          , Gs          , Gs          , Gs          
Gs          , Gs          , Gs          , Gs          , Gs          , Gs          , Gs^Fp       , Rr          , Gs          , Gs          , Gs          , Gg^Ve       , Re^Gvs      , Re^Gvs      , Re^Gvs      , Re^Gvs      , Gs          , Gs          , Gs          , Gs          , Gs          , Gs          , Gs          , Gs          , Gs          , Gs          
Gs          , Gs          , Gs          , Gs          , Gs^Fp       , Gs^Fdf      , Gs          , Rp          , Gs          , Gg^Wm       , Re^Gvs      , Re^Gvs      , Re^Gvs      , Re^Gvs      , Re^Gvs      , Re^Gvs      , Gg^Fet      , Gs          , Gs          , Gs          , Ch          , Gs          , Gs          , Gs          , Gg^Fet      , Gs          
Gs          , Gs          , Gs          , Gs          , Gs          , Gs          , Gs          , Rp          , Rp          , Gs          , Re^Gvs      , Re^Gvs      , Re^Gvs      , Re^Gvs      , Re^Gvs      , Re^Gvs      , Gg^Ve       , Gs          , Ch          , Gs          , Gs          , Gs          , Ch          , Gs          , Gs          , Gs          
Gs          , Gs          , Gs          , Gs          , Gs          , Gs          , Gs          , Gs          , Gs          , Rp          , Gs          , Re^Gvs      , Re^Gvs      , Re^Gvs      , Gg^Ve       , Gs          , Gs          , Gs          , Gs          , Gs          , 2 Kh        , Gs          , Gs          , Gs          , Gs          , Gs          
Gs          , Gs          , Gs          , Gs          , Gs          , Gs          , Ce          , Ce          , Ce          , Rp          , Rp          , Re^Gvs      , Gs          , Gs          , Gs          , Gs          , Rp          , Gs          , Ch          , Gs          , Rp          , Gs          , Ch          , Gs          , Gs          , Gs          
Gs          , Gs          , Gs          , Gs          , Gs          , Gs          , Ce          , 1 Ke        , Ce          , Gs          , Gs          , Rp          , Rp          , Gs          , Rp          , Rp          , Gg^Fet      , Rp          , Rp          , Rp          , Ch          , Rp          , Rp          , Gs          , Gg^Fet      , Gs          
Gs          , Gs          , Gs          , Gs          , Gs          , Gs          , Gs          , Gs          , Gs          , Gs          , Gs          , Gs          , Gs          , Rp          , Gs          , Gs          , Gs          , Gs          , Gs          , Gs          , Gs          , Gs          , Gs          , Rp          , Gs          , Gs          
Gs          , Gs          , Gs          , Gs          , Gs          , Gs          , Gs          , Gs          , Gs          , Gs          , Gs          , Gs          , Gs          , Gs          , Gs          , Gs          , Gs          , Gs          , Gs          , Gs          , Gs          , Gs          , Gs          , Gs          , Gs          , Gs          
